xxxxxxxxxxxxxxxxxxxx
x             x    x
x             x o  x
x             x    x
x                  x
x  xxxxx           x
x      x           x
x      x           x
x  +   x           x
x      x           x
xxxxxxxxxxxxxxxxxxxx
